WWWWWWWWWWWWWWWWWWWWWWWWW
W...........W.....T.....W
W.WW.WWWWWW.A.WWWWWW.WW.W
W.WW.WWWW...W...WWWW.WW.W
W.WD......WWWWW...E...W.W
W...W.WWW...W...WWW.W...W
WWW.W..TWWW.A.WWWT..W.WWW
W...W.W.....W.....W.W...W
W.WWW.WW.WWWWWWW.WW.WWW.W
W.........WWGWW.........W
WWW..W..W.......W.DWT.WWW
W...WWW.WWW.W.WWW.WWW...W
W.W.........W.........W.W
W.WW.WW.WW.WWW.WW.WW.WW.W
W.D.........P......K....W
WWWWWWWWWWWWWWWWWWWWWWWWW
