WWWWWWWWWWWWWWWWWWWWWWWWW
W...........W...........W
W.WW.WWWWWW.A.WWWWWW.WW.W
W.WW.WWWW...W...WWWW.WW.W
W.W.......WWWWW.......W.W
W...W.WWW...W...WWW.W...W
WWW.W...WWW.A.WWW...W.WWW
W...W.W.....W.....W.W...W
W.WWW.WW.WWWWWWW.WW.WWW.W
W.........WWGWW.........W
WWW..W..W.......W..W..WWW
W...WWW.WWW.W.WWW.WWW...W
W.W.........W.........W.W
W.WW.WW.WW.WWW.WW.WW.WW.W
W..........P............W
WWWWWWWWWWWWWWWWWWWWWWWWW
