
WWWWWWWWWWWWWWWWWWWWWWWWW
WA.......E........T.....W
WWWWWWWWWW....WWWWWW.WW.W
W.WW.WWWW...W...WWWW.WW.W
W.WD....A.WWWWW.......W.W
W...W.WWW...W...WWW.W...W
WWW.W..TWWW...WWWT..W.WWW
W...W.W.....W.....W.W...W
W.WWW.WW.WWWWWWW.WW.WWW.W
W.........WWGWW.........W
WWW..W..W.......W.DWT.WWW
W...WWW.WWW.W.WWW.WWW...W
W.W.........W.........W.W
W.WW.WW.WW.WWW.WW.WW.WW.W
W.D.........P......K....W
WWWWWWWWWWWWWWWWWWWWWWWWW
