     WWWWWWWWWWWWWWW
     W.P....A....K.W
     W.WWWW.W.WWWW.W
     W......G....D.W
     WWWWWWWWWW....W
     W...W....E....W
     W.WWWWW.WWWWWWW
     W.......G.....W
     WWWWWWWWWWWWWWW