
WWWWWWWWWWWW
W.P....A..W
W.WWWWWW.WW
W..D....G.W
W.WWWWWW.WW
W...K..E..W
W........W
WWWWWWWWWWWW
