WWWWWWWWWWWWWWW
W.P....A......W
W.WWWW.WWWWWW.W
W.E....G....D.W
W.W.WWWWWW.W.W
W...W....K....W
W.WWWWW.WWWWW.W
W.......G.....W
WWWWWWWWWWWWWWW
