       WWWWWWWWWWW
       W.P....A.KW
       W...WWWW.WW
       W..D.....GW
       W.WWWWWW..W
       W.....W...W
       W.....E...W
       WWWWWWWWWWW






